1111111111
1000000001
1000P00001
1000000001
1000C00001
1000000001
1000E00001
1000000001
1111111111
